%%%%%%%%%%%                                                            
%%%%%%%%%%%                                                            
%%%%%%%%%%%%                                                           
%%%%%%%%%%%%                                                           
%%%%%%%%%%%%                                                           
%%%%%%%%%%%%%                                                          
%%%%%%%%%%%%%                                                          
%%%%%%%%%%%%%                                                          
%%%%%%%%%%%%%                                                          
%%%%%%%%%%%%%                                                          
%%%%%%%%%%%%%                                                          
%%%%%%%%%%%%%                                                          
%%%%%%%%%%%%                                                           
%%%%%%%%%%%%                                                           
%%%%%%%%%%%%                                                           
%%%%%%%%%%%%                                                           
%%%%%%%%%%%%                                                           
%%%%%%%%%%%                                                            
%%%%%%%%%%%                                                            
%%%%%%%%%%%                                                            
%%%%%%%%%%%                                                      %%%%  
%%%%%%%%%%                                                      %%%%%  
%%%%%%%%%%                                                    %%%%%%%% 
%%%%%%%%%%                                                  %%%%%%%%%% 
%%%%%%%%%%                                                 %%%%%%%%%%  
%%%%%%%%%                                                %%%%%%%%%%%%  
%%%%%%%%%                                               %%%%%%%%%%%%%  
%%%%%%%%%                                             %%%%%%%%%%%%%%   
%%%%%%%%                                             %%%%%%%%%%%%%%%   
%%%%%%%%                                            %%%%%%%%%%%%%%%    
%%%%%%%%                                           %%%%%%%%%%%%%%%%    
%%%%%%%                                           %%%%%%%%%%%%%%%%     
%%%%%%%                                          %%%%%%%%%%%%%%%%      
%%%%%%%                                         %%%%%%%%%%%%%%%%       
%%%%%%                                          %%%%%%%%%%%%%%%        
%%%%%%                                         %%%%%%%%%%%%%%%%        
%%%%%                                          %%%%%%%%%%%%%%%         
%%%%%                                         %%%%%%%%%%%%%%%          
%%%%%                                         %%%%%%%%%%%%%%           
%%%%                                          %%%%%%%%%%%%.%           
%%%%                                         %%%%%%%%%%%%...    %%%    
%%%                                          %%%%%%%%%%%...    %%%%    
%%%%%%%%%                                    %%%%%%%%%%%...    %%%%    
%%%%%%%%%%                                   %%%%%%%%%%....   %%%%%    
%%%%%%%%%%%                                 %%%%%%%%%%%...   %%%%%     
%%%%%%%%%%%%                                %%%%%%%%%%....   %%%%%     
%%%%%%%%%%%%                                %%%%%%%%%%...   %%%%%%     
%%%%%%%%%%%%%                               %%%%%%%%%%...   %%%%%      
%%%%%%%%%%%%%                               %%%%%%%%%...   %%%%%%      
%%%%%%%%%%%%%                               %%%%%%%%%...   %%%%%       
%%%%%%%%%%%%%                              %%%%%%%%%%..   %%%%%%       
%%%%%%%%%%%%%                              %%%%%%%%%%.%   %%%%%%       
%%%%%%%%%%%%%                              %%%%%%%%%%%   %%%%%%        
%%%%%%%%%%%%%                              %%%%%%%%%%%   %%%%%%        
%%%%%%%%%%%%%                              %%%%%%%%%%   %%%%%%         
%%%%%%%%%%%%%                             %%%%%%%%%%%   %%%%%          
%%%%%%%%%%%%%                             %%%%%%%%%%   %%%%%%          
%%%%%%%%%%%%%                            %%%%%%%%%%%   %%%%%           
%%%%%%%%%%%%%                            %%%%%%%%%%%  %%%%%%           
%%%%%%%%%%%%%                           %%%%%%%%%%%   %%%%%%           
%%%%%%%%%%%%                            %%%%%%%%%%%  %%%%%%            
%%%%%%%%%%%%                            %%%%%%%%%%%  %%%%%%            
%%%%%%%%%%%%                           %%%%%%%%%%%%  %%%%%             
%%%%%%%%%%%%                           %%%%%%%%%%%  %%%%%%            %
%%%%%%%%%%%                           %%%%%%%%%%%%  %%%%%            %%
%%%%%%%%%%%                           %%%%%%%%%%%% %%%%%%            %%
%%%%%%%%%%%                           %%%%%%%%%%%% %%%%%%           %%%
%%%%%%%%%%                           %%%%%%%%%%%%  %%%%%            %%%
%%%%%%%%%%                           %%%%%%%%%%%% %%%%%%           %%%%
%%%%%%%%%%                          %%%%%%%%%%%%% %%%%%            %%%%
%%%%%%%%%                           %%%%%%%%%%%%% %%%%%           %%%%%
%%%%%%%%%                           %%%%%%%%%%%%%%%%%%%           %%%%%
%%%%%%%%%                          %%%%%%%%%%%%%%%%%%%           %%%%%%
%%%%%%%%                           %%%%%%%%%%%%%%%%%%%           %%%%%%
%%%%%%%%                           %%%%%%%%%%%%%%%%%%           %%%%%%%
%%%%%%%   P                       %%%%%%%%%%%%%%%%%%%           %%%%%%%
%%%%%%%                           %%%%%%%%%%%%%%%%%%%          %%%%%%%%
%%%%%%                           %%%%%%%%%%%%%%%%%%%           %%%%%%%%
%%%%%%                           %%%%%%%%%%%%%%%%%%%          %%%%%%%%%
%%%%%                            %%%%%%%%%%%%%%%%%%%          %%%%%%%%%
%%%%%                           %%%%%% %%%%%%%%%%%%           %%%%%%%%%
%%%%                            %%%%%% %%%%%%%%%%%%          %%%%%%%%%%
%%%%                            %%%%%% %%%%%%%%%%%           %%%%%%%%%%
%%%                            %%%%%% %%%%%%%%%%%%           %%%%%%%%%%
%%%                            %%%%%% %%%%%%%%%%%%          %%%%%%%%%%%
%%                            %%%%%%%%%%%%%%%%%%%           %%%%%%%%%%%
%%                            %%%%%% %%%%%%%%%%%%           %%%%%%%%%%%
%                             %%%%%% %%%%%%%%%%%           %%%%%%%%%%%%
                             %%%%%% %%%%%%%%%%%%           %%%%%%%%%%%%
                             %%%%%% %%%%%%%%%%%%           %%%%%%%%%%%%
                            %%%%%%%%%%%%%%%%%%%            %%%%%%%%%%%%
                            %%%%%% %%%%%%%%%%%%           %%%%%%%%%%%%%
                           %%%%%%% %%%%%%%%%%%            %%%%%%%%%%%%%
                           %%%%%% %%%%%%%%%%%%            %%%%%%%%%%%%%
                          %%%%%%% %%%%%%%%%%%%            %%%%%%%%%%%%%
                          %%%%%%%%%%%%%%%%%%%             %%%%%%%%%%%%%
                         %%%%%%% %%%%%%%%%%%%             %%%%%%%%%%%%%
                         %%%%%%%%%%%%%%%%%%%%             %%%%%%%%%%%%%
                        %%%%%%% %%%%%%%%%%%%%             %%%%%%%%%%%%%
                        %%%%%%%%.%%%%%%%%%%%%             %%%%%%%%%%%%%
                       %%%%%%% ..%%%%%%%%%%%%             %%%%%%%%%%%%%
                       %%%%%%%...%%%%%%%%%%%              %%%%%%%%%%%%%
                      %%%%%%% ...%%%%%%%%%%%              %%%%%%%%%%%%%
                      %%%%%%%...%%%%%%%%%%%%              %%%%%%%%%%%%%
                      %%%%%%....%%%%%%%%%%%%               %%%%%%%%%%%%
                     %%%%%% ....%%%%%%%%%%%%               %%%%%%%%%%%%
                     %%%%%% ...%%%%%%%%%%%%%                %%%%%%%%%%%
                    %%%%%% ....%%%%%%%%%%%%                  %%%%%%%%%%
                    %%%%%% ...%%%%%%%%%%%%%                   %%%%%%%%%
                    %%%%%  ...%%%%%%%%%%%%%                         %%%
                    %%%%  ...%%%%%%%%%%%%%%                        %%%%
                    %%%    .%%%%%%%%%%%%%%                         %%%%
                    %%      %%%%%%%%%%%%%%                        %%%%%
                           %%%%%%%%%%%%%%%                        %%%%%
                          %%%%%%%%%%%%%%%                         %%%%%
                         %%%%%%%%%%%%%%%%                        %%%%%%
                        %%%%%%%%%%%%%%%%                         %%%%%%
                        %%%%%%%%%%%%%%%%                        %%%%%%%
                       %%%%%%%%%%%%%%%%                         %%%%%%%
                      %%%%%%%%%%%%%%%%                          %%%%%%%
                     %%%%%%%%%%%%%%%%                          %%%%%%%%
                     %%%%%%%%%%%%%%%                           %%%%%%%%
                    %%%%%%%%%%%%%%%                            %%%%%%%%
                   %%%%%%%%%%%%%%%                            %%%%%%%%%
                   %%%%%%%%%%%%%                              %%%%%%%%%
                   %%%%%%%%%%%%                               %%%%%%%%%
                  %%%%%%%%%%%                                %%%%%%%%%%
                  %%%%%%%%%%                                 %%%%%%%%%%
                  %%%%%%%%                                   %%%%%%%%%%
                   %%%%%                                     %%%%%%%%%%
                   %%%%                                     %%%%%%%%%%%
                                                            %%%%%%%%%%%
                                                            %%%%%%%%%%%
                                                            %%%%%%%%%%%
                                                           %%%%%%%%%%%%
                                                           %%%%%%%%%%%%
                                                           %%%%%%%%%%%%
                                                           %%%%%%%%%%%%
                                                           %%%%%%%%%%%%
                                                          %%%%%%%%%%%%%
                                                          %%%%%%%%%%%%%
                                                          %%%%%%%%%%%%%
                                                          %%%%%%%%%%%%%
                                                          %%%%%%%%%%%%%
                                                          %%%%%%%%%%%%%
                                                          %%%%%%%%%%%%%
                                                           %%%%%%%%%%%%
                                                           %%%%%%%%%%%%
                                                           %%%%%%%%%%%%
                                                            %%%%%%%%%%%
                                                            %%%%%%%%%%%
